#############################
#                   #       #
#     ######        #       #
#     ######                #
#                   #       #
#   ##      ##      #       #
#   #       ##      #       #
#                   #       #
###############  ######   ###
##########                  #
####          ######        #
####               ##   #####
###           #    #        #
##            #             #
#############################