#####################
#                   #
#     ######        #
#     ######        #
#                   #
#   ##      ##      #
#   #       ##      #
#                   #
#####################